AIR|AIR|AI/RHEUM
ALT|ALT|Alternative Billing Concepts
AOD|AOD|Alcohol and Other Drug Thesaurus
AOT|AOT|Authorized Osteopathic Thesaurus
ATC|ATC|Anatomical Therapeutic Chemical (ATC)-classification system
BI|BI|Beth Israel Problem List
CCC|CCC|Clinical Care Classification
CCPSS|CCPSS|Clinical Problem Statements
CCS|CCS|Clinical Classifications Software
CCS_10|CCS_10|Clinical Classifications Software 10
CDT|CDT|Current Dental Terminology
CHV|CHV|CHV
COSTAR|COSTAR|COSTAR
CPM|CPM|Medical Entities Dictionary
CPT|CPT|CPT
CPTSP|CPTSP|CPT Spanish
CSP|CSP|CRISP Thesaurus
CST|CST|COSTART
CVX|CVX|Vaccines Administered
DDB|DDB|Diseases Database
DMDICD10|DMDICD10|ICD-10 German
DMDUMD|DMDUMD|UMDNS German
DRUGBANK|DRUGBANK|DrugBank
DSM-5|DSM-5|DSM-5
DXP|DXP|DXplain
FMA|FMA|Foundational Model of Anatomy
GO|GO|Gene Ontology
GS|GS|Gold Standard Drug Database
HCDT|HCDT|Current Dental Terminology in HCPCS
HCPCS|HCPCS|HCPCS
HCPT|HCPT|CPT in HCPCS
HGNC|HGNC|HUGO Gene Nomenclature Committee
HL7V2.5|HL7V25|HL7 Version 2.5
HL7V3.0|HL7V30|HL7 Version 3.0
HLREL|HLREL|ICPC2E ICD10 Relationships
HPO|HPO|HPO
ICD10|ICD10|ICD-10
ICD10AE|ICD10AE|ICD-10 Am Engl
ICD10AM|ICD10AM|ICD-10 Austral Mod
ICD10AMAE|ICD10AMAE|ICD-10 Austral Mod Am Engl
ICD10CM|ICD10CM|ICD-10-CM
ICD10DUT|ICD10DUT|ICD10
ICD10PCS|ICD10PCS|ICD-10-PCS
ICD9CM|ICD9CM|ICD-9-CM
ICF|ICF|International Classification of Functioning
ICF-CY|ICF-CY|International Classification of Functioning
ICNP|ICNP|ICNP
ICPC|ICPC|ICPC
ICPC2EDUT|ICPC2EDUT|ICPC2E Dutch
ICPC2EENG|ICPC2EENG|ICPC2E
ICPC2ICD10DUT|ICPC2ICD10DUT|ICPC2-ICD10ENG Thesaurus Dutch
ICPC2ICD10ENG|ICPC2ICD10ENG|ICPC2-ICD10 Thesaurus
ICPC2P|ICPC2P|ICPC-2 PLUS
ICPCBAQ|ICPCBAQ|ICPC Basque
ICPCDAN|ICPCDAN|ICPC Danish
ICPCDUT|ICPCDUT|ICPC Dutch
ICPCFIN|ICPCFIN|ICPC Finnish
ICPCFRE|ICPCFRE|ICPC French
ICPCGER|ICPCGER|ICPC German
ICPCHEB|ICPCHEB|ICPC Hebrew
ICPCHUN|ICPCHUN|ICPC Hungarian
ICPCITA|ICPCITA|ICPC Italian
ICPCNOR|ICPCNOR|ICPC Norwegian
ICPCPOR|ICPCPOR|ICPC Portuguese
ICPCSPA|ICPCSPA|ICPC Spanish
ICPCSWE|ICPCSWE|ICPC Swedish
JABL|JABL|Congenital Mental Retardation Syndromes
KCD5|KCD5|KCD5
LCH|LCH|Library of Congress Subject Headings
LCH_NW|LCH_NW|Library of Congress Subject Headings
LNC|LNC|LOINC
LNC-DE-AT|LNC-DE-AT|LOINC Linguistic Variant - German
LNC-DE-CH|LNC-DE-CH|LOINC Linguistic Variant - German
LNC-DE-DE|LNC-DE-DE|LOINC Linguistic Variant - German
LNC-EL-GR|LNC-EL-GR|LOINC Linguistic Variant - Greek
LNC-ES-AR|LNC-ES-AR|LOINC Linguistic Variant - Spanish
LNC-ES-CH|LNC-ES-CH|LOINC Linguistic Variant - Spanish
LNC-ES-ES|LNC-ES-ES|LOINC Linguistic Variant - Spanish
LNC-ET-EE|LNC-ET-EE|LOINC Linguistic Variant - Estonian
LNC-FR-BE|LNC-FR-BE|LOINC Linguistic Variant - French
LNC-FR-CA|LNC-FR-CA|LOINC Linguistic Variant - French
LNC-FR-CH|LNC-FR-CH|LOINC Linguistic Variant - French
LNC-FR-FR|LNC-FR-FR|LOINC Linguistic Variant - French
LNC-IT-CH|LNC-IT-CH|LOINC Linguistic Variant - Italian
LNC-IT-IT|LNC-IT-IT|LOINC Linguistic Variant - Italian
LNC-KO-KR|LNC-KO-KR|LOINC Linguistic Variant - Korea
LNC-NL-NL|LNC-NL-NL|LOINC Linguistic Variant - Dutch
LNC-PT-BR|LNC-PT-BR|LOINC Linguistic Variant - Portuguese
LNC-RU-RU|LNC-RU-RU|LOINC Linguistic Variant - Russian
LNC-TR-TR|LNC-TR-TR|LOINC Linguistic Variant - Turkish
LNC-ZH-CN|LNC-ZH-CN|LOINC Linguistic Variant - Chinese
MCM|MCM|Glossary of Clinical Epidemiologic Terms
MDR|MDR|MedDRA
MDRCZE|MDRCZE|MedDRA Czech
MDRDUT|MDRDUT|MedDRA Dutch
MDRFRE|MDRFRE|MedDRA French
MDRGER|MDRGER|MedDRA German
MDRHUN|MDRHUN|MedDRA Hungarian
MDRITA|MDRITA|MedDRA Italian
MDRJPN|MDRJPN|MedDRA Japanese
MDRPOR|MDRPOR|MedDRA Portuguese
MDRSPA|MDRSPA|MedDRA Spanish
MEDCIN|MEDCIN|MEDCIN
MEDLINEPLUS|MEDLINEPLUS|MedlinePlus
MMSL|MMSL|Multum
MMX|MMX|Micromedex
MSH|MSH|MeSH
MSHCZE|MSHCZE|MeSH Czech
MSHDUT|MSHDUT|MeSH Dutch
MSHFIN|MSHFIN|MeSH Finnish
MSHFRE|MSHFRE|MeSH French
MSHGER|MSHGER|MeSH German
MSHITA|MSHITA|MeSH Italian
MSHJPN|MSHJPN|MeSH Japanese
MSHLAV|MSHLAV|MeSH Latvian
MSHNOR|MSHNOR|MeSH Norwegian
MSHPOL|MSHPOL|MeSH Polish
MSHPOR|MSHPOR|MeSH Portuguese
MSHRUS|MSHRUS|MeSH Russian
MSHSCR|MSHSCR|MeSH Croatian
MSHSPA|MSHSPA|MeSH Spanish
MSHSWE|MSHSWE|MeSH Swedish
MTH|MTH|Metathesaurus Names
MTHCMSFRF|MTHCMSFRF|Metathesaurus CMS Formulary Reference File
MTHHH|MTHHH|HCPCS Hierarchical Terms (UMLS)
MTHICD9|MTHICD9|ICD-9-CM Entry Terms
MTHICPC2EAE|MTHICPC2EAE|ICPC2E Am Engl
MTHICPC2ICD10AE|MTHICPC2ICD10AE|ICPC2-ICD10 Thesaurus
MTHMST|MTHMST|Minimal Standard Terminology (UMLS)
MTHMSTFRE|MTHMSTFRE|Minimal Standard Terminology French (UMLS)
MTHMSTITA|MTHMSTITA|Minimal Standard Terminology Italian (UMLS)
MTHSPL|MTHSPL|FDA Structured Product Labels
MVX|MVX|Manufacturers of Vaccines
NANDA-I|NANDA-I|NANDA-I
NCBI|NCBI|NCBI Taxonomy
NCI|NCI|NCI Thesaurus
NCISEER|NCISEER|NCI SEER ICD Mappings
NCI_BRIDG|NCI_BRIDG|Biomedical Research Integrated Domain Group Model
NCI_BioC|NCI_BioC|BioCarta online maps of molecular pathways
NCI_CDC|NCI_CDC|U.S. Centers for Disease Control and Prevention
NCI_CDISC|NCI_CDISC|Clinical Data Interchange Standards Consortium
NCI_CRCH|NCI_CRCH|Cancer Research Center of Hawaii Nutrition Terminology
NCI_CTCAE|NCI_CTCAE|Common Terminology Criteria for Adverse Events
NCI_CTEP-SDC|NCI_CTEP-SDC|Cancer Therapy Evaluation Program - Simple Disease Classification
NCI_CareLex|NCI_CareLex|Content Archive Resource Exchange Lexicon
NCI_DCP|NCI_DCP|NCI Division of Cancer Prevention Program
NCI_DICOM|NCI_DICOM|Digital Imaging Communications in Medicine
NCI_DTP|NCI_DTP|NCI Developmental Therapeutics Program
NCI_FDA|NCI_FDA|U.S. Food and Drug Administration
NCI_GAIA|NCI_GAIA|Global Alignment of Immunization Safety Assessment in pregnancy
NCI_GENC|NCI_GENC|Geopolitical Entities
NCI_NCI-HGNC|NCI_NCI-HGNC|NCI HUGO Gene Nomenclature
NCI_ICH|NCI_ICH|International Conference on Harmonization
NCI_JAX|NCI_JAX|Jackson Laboratories Mouse Terminology
NCI_KEGG|NCI_KEGG|KEGG Pathway Database
NCI_NCI-GLOSS|NCI_NCI-GLOSS|NCI Dictionary of Cancer Terms
NCI_NCI-HL7|NCI_NCI-HL7|NCI Health Level 7
NCI_NCPDP|NCI_NCPDP|National Council for Prescription Drug Programs
NCI_NICHD|NCI_NICHD|National Institute of Child Health and Human Development
NCI_PI-RADS|NCI_PI-RADS|Prostate Imaging Reporting and Data System
NCI_PID|NCI_PID|National Cancer Institute Nature Pathway Interaction Database
NCI_RENI|NCI_RENI|Registry Nomenclature Information System
NCI_UCUM|NCI_UCUM|Unified Code for Units of Measure
NCI_ZFin|NCI_ZFin|Zebrafish Model Organism Database
NDDF|NDDF|FDB MedKnowledge
NDFRT|NDFRT|National Drug File - Reference Terminology
NDFRT_FDASPL|NDFRT_FDASPL|National Drug File - FDASPL
NDFRT_FMTSME|NDFRT_FMTSME|National Drug File - FMTSME
NEU|NEU|Neuronames Brain Hierarchy
NIC|NIC|Nursing Interventions Classification
NOC|NOC|Nursing Outcomes Classification
NUCCPT|NUCCPT|National Uniform Claim Committee - Health Care Provider Taxonomy
OMIM|OMIM|OMIM
OMS|OMS|Omaha System
PCDS|PCDS|Patient Care Data Set
PDQ|PDQ|PDQ
PNDS|PNDS|PNDS
PPAC|PPAC|Pharmacy Practice Activity Classification
PSY|PSY|Psychological Index Terms
QMR|QMR|Quick Medical Reference
RAM|RAM|Clinical Concepts by R A Miller
RCD|RCD|Read Codes
RCDAE|RCDAE|Read Codes Am Engl
RCDSA|RCDSA|Read Codes Am Synth
RCDSY|RCDSY|Read Codes Synth
RXNORM|RXNORM|RXNORM
SCTSPA|SCTSPA|SNOMED Terminos Clinicos
SNM|SNM|SNOMED 1982
SNMI|SNMI|SNOMED Intl 1998
SNOMEDCT_US|SNOMEDCT_US|SNOMED Clinical Terms US Edition
SNOMEDCT_VET|SNOMEDCT_VET|The Veterinary Extension to SNOMED CT
SOP|SOP|Source of Payment Typology
SPN|SPN|Standard Product Nomenclature
SRC|SRC|Source Terminology Names (UMLS)
TKMT|TKMT|TKMT
ULT|ULT|UltraSTAR
UMD|UMD|UMDNS
USPMG|USPMG|USP Model Guidelines
UWDA|UWDA|Digital Anatomist
VANDF|VANDF|National Drug File
WHO|WHO|WHOART
WHOFRE|WHOFRE|WHOART French
WHOGER|WHOGER|WHOART German
WHOPOR|WHOPOR|WHOART Portuguese
WHOSPA|WHOSPA|WHOART Spanish